Index,year,county,property,violent,total_index_crimes
1990-Albany,1990,Albany,12894,1524,14418
1990-Allegany,1990,Allegany,1134,146,1280
1990-Bronx,1990,Bronx,71094,33635,104729
1990-Broome,1990,Broome,7174,306,7480
1990-Cattaraugus,1990,Cattaraugus,2407,171,2578
1990-Cayuga,1990,Cayuga,2135,196,2331
1990-Chautauqua,1990,Chautauqua,5484,229,5713
1990-Chemung,1990,Chemung,3532,284,3816
1990-Chenango,1990,Chenango,1100,78,1178
1990-Clinton,1990,Clinton,1979,242,2221
1990-Columbia,1990,Columbia,1701,253,1954
1990-Cortland,1990,Cortland,2027,96,2123
1990-Delaware,1990,Delaware,1019,73,1092
1990-Dutchess,1990,Dutchess,7853,1104,8957
1990-Erie,1990,Erie,44924,7390,52314
1990-Essex,1990,Essex,881,78,959
1990-Franklin,1990,Franklin,940,226,1166
1990-Fulton,1990,Fulton,2161,98,2259
1990-Genesee,1990,Genesee,1558,89,1647
1990-Greene,1990,Greene,1235,205,1440
1990-Hamilton,1990,Hamilton,96,4,100
1990-Herkimer,1990,Herkimer,1210,77,1287
1990-Jefferson,1990,Jefferson,2948,187,3135
1990-Kings,1990,Kings,138922,63087,202009
1990-Lewis,1990,Lewis,286,36,322
1990-Livingston,1990,Livingston,1768,147,1915
1990-Madison,1990,Madison,1853,60,1913
1990-Monroe,1990,Monroe,39262,3317,42579
1990-Montgomery,1990,Montgomery,981,34,1015
1990-Nassau,1990,Nassau,38919,3223,42142
1990-New York,1990,New York,173352,44434,217786
1990-Niagara,1990,Niagara,8824,986,9810
1990-Oneida,1990,Oneida,7360,388,7748
1990-Onondaga,1990,Onondaga,20077,1746,21823
1990-Ontario,1990,Ontario,2467,121,2588
1990-Orange,1990,Orange,9786,1339,11125
1990-Orleans,1990,Orleans,945,159,1104
1990-Oswego,1990,Oswego,3268,106,3374
1990-Otsego,1990,Otsego,1148,66,1214
1990-Putnam,1990,Putnam,1768,135,1903
1990-Queens,1990,Queens,134738,30441,165179
1990-Rensselaer,1990,Rensselaer,5037,401,5438
1990-Richmond,1990,Richmond,18761,3092,21853
1990-Rockland,1990,Rockland,7799,709,8508
1990-Saratoga,1990,Saratoga,4676,476,5152
1990-Schenectady,1990,Schenectady,5537,387,5924
1990-Schoharie,1990,Schoharie,697,52,749
1990-Schuyler,1990,Schuyler,627,19,646
1990-Seneca,1990,Seneca,741,52,793
1990-St Lawrence,1990,St Lawrence,3260,281,3541
1990-Steuben,1990,Steuben,3164,246,3410
1990-Suffolk,1990,Suffolk,57514,3786,61300
1990-Sullivan,1990,Sullivan,2869,300,3169
1990-Tioga,1990,Tioga,794,121,915
1990-Tompkins,1990,Tompkins,4352,143,4495
1990-Ulster,1990,Ulster,4929,613,5542
1990-Warren,1990,Warren,2221,285,2506
1990-Washington,1990,Washington,1232,180,1412
1990-Wayne,1990,Wayne,2425,179,2604
1990-Westchester,1990,Westchester,34274,3871,38145
1990-Wyoming,1990,Wyoming,1142,212,1354
1990-Yates,1990,Yates,473,34,507
1991-Albany,1991,Albany,13790,1674,15464
1991-Allegany,1991,Allegany,1283,134,1417
1991-Bronx,1991,Bronx,66556,33515,100071
1991-Broome,1991,Broome,7108,339,7447
1991-Cattaraugus,1991,Cattaraugus,2366,273,2639
1991-Cayuga,1991,Cayuga,2338,216,2554
1991-Chautauqua,1991,Chautauqua,5245,227,5472
1991-Chemung,1991,Chemung,3934,256,4190
1991-Chenango,1991,Chenango,1146,97,1243
1991-Clinton,1991,Clinton,2247,269,2516
1991-Columbia,1991,Columbia,1960,363,2323
1991-Cortland,1991,Cortland,2110,83,2193
1991-Delaware,1991,Delaware,1127,75,1202
1991-Dutchess,1991,Dutchess,8266,974,9240
1991-Erie,1991,Erie,47137,8277,55414
1991-Essex,1991,Essex,817,82,899
1991-Franklin,1991,Franklin,950,197,1147
1991-Fulton,1991,Fulton,2129,123,2252
1991-Genesee,1991,Genesee,1645,107,1752
1991-Greene,1991,Greene,1405,221,1626
1991-Hamilton,1991,Hamilton,148,10,158
1991-Herkimer,1991,Herkimer,1504,104,1608
1991-Jefferson,1991,Jefferson,3000,202,3202
1991-Kings,1991,Kings,130445,60814,191259
1991-Lewis,1991,Lewis,313,16,329
1991-Livingston,1991,Livingston,1763,151,1914
1991-Madison,1991,Madison,1775,76,1851
1991-Monroe,1991,Monroe,41001,2857,43858
1991-Montgomery,1991,Montgomery,1065,50,1115
1991-Nassau,1991,Nassau,39371,3848,43219
1991-New York,1991,New York,167968,41209,209177
1991-Niagara,1991,Niagara,9235,930,10165
1991-Oneida,1991,Oneida,8744,489,9233
1991-Onondaga,1991,Onondaga,21338,1916,23254
1991-Ontario,1991,Ontario,2535,90,2625
1991-Orange,1991,Orange,9944,1263,11207
1991-Orleans,1991,Orleans,1162,151,1313
1991-Oswego,1991,Oswego,3448,136,3584
1991-Otsego,1991,Otsego,1312,62,1374
1991-Putnam,1991,Putnam,1734,109,1843
1991-Queens,1991,Queens,128384,31821,160205
1991-Rensselaer,1991,Rensselaer,5041,459,5500
1991-Richmond,1991,Richmond,16682,3127,19809
1991-Rockland,1991,Rockland,7123,787,7910
1991-Saratoga,1991,Saratoga,4734,558,5292
1991-Schenectady,1991,Schenectady,5722,642,6364
1991-Schoharie,1991,Schoharie,684,57,741
1991-Schuyler,1991,Schuyler,553,30,583
1991-Seneca,1991,Seneca,754,54,808
1991-St Lawrence,1991,St Lawrence,3644,209,3853
1991-Steuben,1991,Steuben,3309,200,3509
1991-Suffolk,1991,Suffolk,63708,3989,67697
1991-Sullivan,1991,Sullivan,2891,338,3229
1991-Tioga,1991,Tioga,1110,166,1276
1991-Tompkins,1991,Tompkins,4680,182,4862
1991-Ulster,1991,Ulster,4640,544,5184
1991-Warren,1991,Warren,2423,298,2721
1991-Washington,1991,Washington,1293,209,1502
1991-Wayne,1991,Wayne,2896,197,3093
1991-Westchester,1991,Westchester,33185,3933,37118
1991-Wyoming,1991,Wyoming,998,222,1220
1991-Yates,1991,Yates,621,57,678
1992-Albany,1992,Albany,14661,1588,16249
1992-Allegany,1992,Allegany,1217,161,1378
1992-Bronx,1992,Bronx,61501,31050,92551
1992-Broome,1992,Broome,6574,365,6939
1992-Cattaraugus,1992,Cattaraugus,2262,322,2584
1992-Cayuga,1992,Cayuga,2146,210,2356
1992-Chautauqua,1992,Chautauqua,5021,296,5317
1992-Chemung,1992,Chemung,3757,298,4055
1992-Chenango,1992,Chenango,1190,125,1315
1992-Clinton,1992,Clinton,1859,210,2069
1992-Columbia,1992,Columbia,1606,269,1875
1992-Cortland,1992,Cortland,1998,110,2108
1992-Delaware,1992,Delaware,991,85,1076
1992-Dutchess,1992,Dutchess,8029,1017,9046
1992-Erie,1992,Erie,47788,8516,56304
1992-Essex,1992,Essex,783,88,871
1992-Franklin,1992,Franklin,903,160,1063
1992-Fulton,1992,Fulton,1941,123,2064
1992-Genesee,1992,Genesee,1688,79,1767
1992-Greene,1992,Greene,1147,261,1408
1992-Hamilton,1992,Hamilton,144,2,146
1992-Herkimer,1992,Herkimer,1534,193,1727
1992-Jefferson,1992,Jefferson,2553,249,2802
1992-Kings,1992,Kings,120017,56682,176699
1992-Lewis,1992,Lewis,274,24,298
1992-Livingston,1992,Livingston,1662,121,1783
1992-Madison,1992,Madison,1687,86,1773
1992-Monroe,1992,Monroe,41489,2985,44474
1992-Montgomery,1992,Montgomery,961,30,991
1992-Nassau,1992,Nassau,36485,3718,40203
1992-New York,1992,New York,150159,37788,187947
1992-Niagara,1992,Niagara,9001,1087,10088
1992-Oneida,1992,Oneida,8523,617,9140
1992-Onondaga,1992,Onondaga,19448,1915,21363
1992-Ontario,1992,Ontario,2381,136,2517
1992-Orange,1992,Orange,9264,1254,10518
1992-Orleans,1992,Orleans,1133,178,1311
1992-Oswego,1992,Oswego,3440,113,3553
1992-Otsego,1992,Otsego,1181,66,1247
1992-Putnam,1992,Putnam,1566,107,1673
1992-Queens,1992,Queens,121080,30816,151896
1992-Rensselaer,1992,Rensselaer,5286,375,5661
1992-Richmond,1992,Richmond,14825,3319,18144
1992-Rockland,1992,Rockland,6985,730,7715
1992-Saratoga,1992,Saratoga,4599,566,5165
1992-Schenectady,1992,Schenectady,6020,924,6944
1992-Schoharie,1992,Schoharie,624,59,683
1992-Schuyler,1992,Schuyler,461,35,496
1992-Seneca,1992,Seneca,667,36,703
1992-St Lawrence,1992,St Lawrence,3577,233,3810
1992-Steuben,1992,Steuben,3195,244,3439
1992-Suffolk,1992,Suffolk,59824,4218,64042
1992-Sullivan,1992,Sullivan,2538,334,2872
1992-Tioga,1992,Tioga,1018,183,1201
1992-Tompkins,1992,Tompkins,4589,181,4770
1992-Ulster,1992,Ulster,4710,501,5211
1992-Warren,1992,Warren,2499,373,2872
1992-Washington,1992,Washington,1163,189,1352
1992-Wayne,1992,Wayne,2773,187,2960
1992-Westchester,1992,Westchester,30553,3722,34275
1992-Wyoming,1992,Wyoming,990,189,1179
1992-Yates,1992,Yates,481,67,548
1993-Albany,1993,Albany,13470,1669,15139
1993-Allegany,1993,Allegany,1134,131,1265
1993-Bronx,1993,Bronx,60692,31235,91927
1993-Broome,1993,Broome,7237,389,7626
1993-Cattaraugus,1993,Cattaraugus,2403,291,2694
1993-Cayuga,1993,Cayuga,1998,205,2203
1993-Chautauqua,1993,Chautauqua,4575,395,4970
1993-Chemung,1993,Chemung,3499,238,3737
1993-Chenango,1993,Chenango,1035,140,1175
1993-Clinton,1993,Clinton,1721,181,1902
1993-Columbia,1993,Columbia,1485,274,1759
1993-Cortland,1993,Cortland,1991,102,2093
1993-Delaware,1993,Delaware,1062,88,1150
1993-Dutchess,1993,Dutchess,7020,888,7908
1993-Erie,1993,Erie,45298,8100,53398
1993-Essex,1993,Essex,676,96,772
1993-Franklin,1993,Franklin,1031,177,1208
1993-Fulton,1993,Fulton,2074,123,2197
1993-Genesee,1993,Genesee,1575,92,1667
1993-Greene,1993,Greene,1103,299,1402
1993-Hamilton,1993,Hamilton,120,8,128
1993-Herkimer,1993,Herkimer,1280,189,1469
1993-Jefferson,1993,Jefferson,2695,187,2882
1993-Kings,1993,Kings,114305,54931,169236
1993-Lewis,1993,Lewis,286,31,317
1993-Livingston,1993,Livingston,1566,135,1701
1993-Madison,1993,Madison,1461,59,1520
1993-Monroe,1993,Monroe,39307,3132,42439
1993-Montgomery,1993,Montgomery,972,41,1013
1993-Nassau,1993,Nassau,35398,3567,38965
1993-New York,1993,New York,136551,35470,172021
1993-Niagara,1993,Niagara,8951,950,9901
1993-Oneida,1993,Oneida,7639,601,8240
1993-Onondaga,1993,Onondaga,18547,1716,20263
1993-Ontario,1993,Ontario,2399,162,2561
1993-Orange,1993,Orange,8898,1195,10093
1993-Orleans,1993,Orleans,1124,99,1223
1993-Oswego,1993,Oswego,3355,97,3452
1993-Otsego,1993,Otsego,1260,96,1356
1993-Putnam,1993,Putnam,1464,79,1543
1993-Queens,1993,Queens,120451,28565,149016
1993-Rensselaer,1993,Rensselaer,5207,471,5678
1993-Richmond,1993,Richmond,14856,3347,18203
1993-Rockland,1993,Rockland,7030,618,7648
1993-Saratoga,1993,Saratoga,3760,517,4277
1993-Schenectady,1993,Schenectady,5662,744,6406
1993-Schoharie,1993,Schoharie,538,49,587
1993-Schuyler,1993,Schuyler,390,38,428
1993-Seneca,1993,Seneca,612,44,656
1993-St Lawrence,1993,St Lawrence,3229,218,3447
1993-Steuben,1993,Steuben,2799,205,3004
1993-Suffolk,1993,Suffolk,55442,3799,59241
1993-Sullivan,1993,Sullivan,2732,379,3111
1993-Tioga,1993,Tioga,936,180,1116
1993-Tompkins,1993,Tompkins,4652,217,4869
1993-Ulster,1993,Ulster,4492,556,5048
1993-Warren,1993,Warren,2447,302,2749
1993-Washington,1993,Washington,1093,215,1308
1993-Wayne,1993,Wayne,2661,178,2839
1993-Westchester,1993,Westchester,28887,3840,32727
1993-Wyoming,1993,Wyoming,959,192,1151
1993-Yates,1993,Yates,494,59,553
1994-Albany,1994,Albany,14953,1771,16724
1994-Allegany,1994,Allegany,1106,129,1235
1994-Bronx,1994,Bronx,56467,27863,84330
1994-Broome,1994,Broome,7272,437,7709
1994-Cattaraugus,1994,Cattaraugus,2342,279,2621
1994-Cayuga,1994,Cayuga,1912,186,2098
1994-Chautauqua,1994,Chautauqua,4801,450,5251
1994-Chemung,1994,Chemung,3648,260,3908
1994-Chenango,1994,Chenango,1160,196,1356
1994-Clinton,1994,Clinton,1707,224,1931
1994-Columbia,1994,Columbia,1449,241,1690
1994-Cortland,1994,Cortland,1940,99,2039
1994-Delaware,1994,Delaware,1108,76,1184
1994-Dutchess,1994,Dutchess,6681,889,7570
1994-Erie,1994,Erie,42905,8752,51657
1994-Essex,1994,Essex,649,91,740
1994-Franklin,1994,Franklin,961,232,1193
1994-Fulton,1994,Fulton,2003,122,2125
1994-Genesee,1994,Genesee,1588,102,1690
1994-Greene,1994,Greene,1044,271,1315
1994-Hamilton,1994,Hamilton,106,5,111
1994-Herkimer,1994,Herkimer,1268,163,1431
1994-Jefferson,1994,Jefferson,2642,179,2821
1994-Kings,1994,Kings,100186,48212,148398
1994-Lewis,1994,Lewis,238,24,262
1994-Livingston,1994,Livingston,1428,119,1547
1994-Madison,1994,Madison,1515,48,1563
1994-Monroe,1994,Monroe,34718,3246,37964
1994-Montgomery,1994,Montgomery,971,70,1041
1994-Nassau,1994,Nassau,31426,3135,34561
1994-New York,1994,New York,119188,31895,151083
1994-Niagara,1994,Niagara,8506,860,9366
1994-Oneida,1994,Oneida,7325,571,7896
1994-Onondaga,1994,Onondaga,18104,1584,19688
1994-Ontario,1994,Ontario,2328,102,2430
1994-Orange,1994,Orange,8624,1345,9969
1994-Orleans,1994,Orleans,924,66,990
1994-Oswego,1994,Oswego,3312,75,3387
1994-Otsego,1994,Otsego,1156,87,1243
1994-Putnam,1994,Putnam,1327,64,1391
1994-Queens,1994,Queens,103638,25412,129050
1994-Rensselaer,1994,Rensselaer,4922,483,5405
1994-Richmond,1994,Richmond,14777,3189,17966
1994-Rockland,1994,Rockland,6719,659,7378
1994-Saratoga,1994,Saratoga,3698,456,4154
1994-Schenectady,1994,Schenectady,6030,783,6813
1994-Schoharie,1994,Schoharie,493,47,540
1994-Schuyler,1994,Schuyler,302,36,338
1994-Seneca,1994,Seneca,740,47,787
1994-St Lawrence,1994,St Lawrence,3238,208,3446
1994-Steuben,1994,Steuben,3082,221,3303
1994-Suffolk,1994,Suffolk,48566,3154,51720
1994-Sullivan,1994,Sullivan,2734,381,3115
1994-Tioga,1994,Tioga,883,137,1020
1994-Tompkins,1994,Tompkins,4334,134,4468
1994-Ulster,1994,Ulster,4437,593,5030
1994-Warren,1994,Warren,2071,278,2349
1994-Washington,1994,Washington,1095,197,1292
1994-Wayne,1994,Wayne,2499,203,2702
1994-Westchester,1994,Westchester,27534,3632,31166
1994-Wyoming,1994,Wyoming,881,171,1052
1994-Yates,1994,Yates,556,52,608
1995-Albany,1995,Albany,15093,1606,16699
1995-Allegany,1995,Allegany,1087,160,1247
1995-Bronx,1995,Bronx,48737,24660,73397
1995-Broome,1995,Broome,6590,420,7010
1995-Cattaraugus,1995,Cattaraugus,2398,279,2677
1995-Cayuga,1995,Cayuga,2224,233,2457
1995-Chautauqua,1995,Chautauqua,5026,399,5425
1995-Chemung,1995,Chemung,3328,217,3545
1995-Chenango,1995,Chenango,1236,169,1405
1995-Clinton,1995,Clinton,1583,290,1873
1995-Columbia,1995,Columbia,1434,322,1756
1995-Cortland,1995,Cortland,2013,88,2101
1995-Delaware,1995,Delaware,1061,92,1153
1995-Dutchess,1995,Dutchess,6584,1103,7687
1995-Erie,1995,Erie,41718,8179,49897
1995-Essex,1995,Essex,653,74,727
1995-Franklin,1995,Franklin,1030,237,1267
1995-Fulton,1995,Fulton,2135,141,2276
1995-Genesee,1995,Genesee,1655,104,1759
1995-Greene,1995,Greene,1064,283,1347
1995-Hamilton,1995,Hamilton,148,3,151
1995-Herkimer,1995,Herkimer,1503,190,1693
1995-Jefferson,1995,Jefferson,2314,150,2464
1995-Kings,1995,Kings,83846,39887,123733
1995-Lewis,1995,Lewis,274,25,299
1995-Livingston,1995,Livingston,1534,140,1674
1995-Madison,1995,Madison,1584,69,1653
1995-Monroe,1995,Monroe,36932,3071,40003
1995-Montgomery,1995,Montgomery,1265,108,1373
1995-Nassau,1995,Nassau,30031,3198,33229
1995-New York,1995,New York,98543,25095,123638
1995-Niagara,1995,Niagara,8507,865,9372
1995-Oneida,1995,Oneida,7427,617,8044
1995-Onondaga,1995,Onondaga,18685,1804,20489
1995-Ontario,1995,Ontario,2464,128,2592
1995-Orange,1995,Orange,9232,1174,10406
1995-Orleans,1995,Orleans,776,83,859
1995-Oswego,1995,Oswego,3190,164,3354
1995-Otsego,1995,Otsego,1214,110,1324
1995-Putnam,1995,Putnam,1294,60,1354
1995-Queens,1995,Queens,86146,21789,107935
1995-Rensselaer,1995,Rensselaer,5102,463,5565
1995-Richmond,1995,Richmond,11080,2749,13829
1995-Rockland,1995,Rockland,7820,767,8587
1995-Saratoga,1995,Saratoga,3767,519,4286
1995-Schenectady,1995,Schenectady,6029,616,6645
1995-Schoharie,1995,Schoharie,535,51,586
1995-Schuyler,1995,Schuyler,466,38,504
1995-Seneca,1995,Seneca,748,43,791
1995-St Lawrence,1995,St Lawrence,3005,205,3210
1995-Steuben,1995,Steuben,3252,214,3466
1995-Suffolk,1995,Suffolk,44429,2758,47187
1995-Sullivan,1995,Sullivan,2690,341,3031
1995-Tioga,1995,Tioga,821,98,919
1995-Tompkins,1995,Tompkins,3891,163,4054
1995-Ulster,1995,Ulster,4252,524,4776
1995-Warren,1995,Warren,2077,281,2358
1995-Washington,1995,Washington,1233,162,1395
1995-Wayne,1995,Wayne,2150,183,2333
1995-Westchester,1995,Westchester,27429,3572,31001
1995-Wyoming,1995,Wyoming,1008,138,1146
1995-Yates,1995,Yates,491,60,551
1996-Albany,1996,Albany,12268,1408,13676
1996-Allegany,1996,Allegany,1003,93,1096
1996-Bronx,1996,Bronx,43157,20615,63772
1996-Broome,1996,Broome,7059,424,7483
1996-Cattaraugus,1996,Cattaraugus,2130,251,2381
1996-Cayuga,1996,Cayuga,2089,163,2252
1996-Chautauqua,1996,Chautauqua,4810,341,5151
1996-Chemung,1996,Chemung,3337,273,3610
1996-Chenango,1996,Chenango,1257,161,1418
1996-Clinton,1996,Clinton,1628,357,1985
1996-Columbia,1996,Columbia,1480,231,1711
1996-Cortland,1996,Cortland,2114,128,2242
1996-Delaware,1996,Delaware,1034,87,1121
1996-Dutchess,1996,Dutchess,6700,935,7635
1996-Erie,1996,Erie,40674,5546,46220
1996-Essex,1996,Essex,653,75,728
1996-Franklin,1996,Franklin,978,179,1157
1996-Fulton,1996,Fulton,1971,174,2145
1996-Genesee,1996,Genesee,1522,126,1648
1996-Greene,1996,Greene,955,267,1222
1996-Hamilton,1996,Hamilton,103,8,111
1996-Herkimer,1996,Herkimer,1281,136,1417
1996-Jefferson,1996,Jefferson,2693,193,2886
1996-Kings,1996,Kings,71861,34798,106659
1996-Lewis,1996,Lewis,385,34,419
1996-Livingston,1996,Livingston,1596,123,1719
1996-Madison,1996,Madison,1584,99,1683
1996-Monroe,1996,Monroe,35012,2800,37812
1996-Montgomery,1996,Montgomery,1307,113,1420
1996-Nassau,1996,Nassau,29145,3268,32413
1996-New York,1996,New York,85392,22006,107398
1996-Niagara,1996,Niagara,8245,878,9123
1996-Oneida,1996,Oneida,7374,619,7993
1996-Onondaga,1996,Onondaga,18574,1729,20303
1996-Ontario,1996,Ontario,2379,84,2463
1996-Orange,1996,Orange,8664,1145,9809
1996-Orleans,1996,Orleans,858,101,959
1996-Oswego,1996,Oswego,3199,193,3392
1996-Otsego,1996,Otsego,1314,101,1415
1996-Putnam,1996,Putnam,1305,70,1375
1996-Queens,1996,Queens,75037,18786,93823
1996-Rensselaer,1996,Rensselaer,5541,503,6044
1996-Richmond,1996,Richmond,9428,2523,11951
1996-Rockland,1996,Rockland,7139,658,7797
1996-Saratoga,1996,Saratoga,3858,524,4382
1996-Schenectady,1996,Schenectady,5565,557,6122
1996-Schoharie,1996,Schoharie,543,45,588
1996-Schuyler,1996,Schuyler,329,22,351
1996-Seneca,1996,Seneca,739,46,785
1996-St Lawrence,1996,St Lawrence,3072,194,3266
1996-Steuben,1996,Steuben,2676,204,2880
1996-Suffolk,1996,Suffolk,42664,2567,45231
1996-Sullivan,1996,Sullivan,2541,398,2939
1996-Tioga,1996,Tioga,781,58,839
1996-Tompkins,1996,Tompkins,3437,141,3578
1996-Ulster,1996,Ulster,3956,592,4548
1996-Warren,1996,Warren,2119,201,2320
1996-Washington,1996,Washington,1088,62,1150
1996-Wayne,1996,Wayne,1920,136,2056
1996-Westchester,1996,Westchester,26259,3227,29486
1996-Wyoming,1996,Wyoming,986,122,1108
1996-Yates,1996,Yates,467,30,497
1997-Albany,1997,Albany,13092,1450,14542
1997-Allegany,1997,Allegany,859,84,943
1997-Bronx,1997,Bronx,38034,19592,57626
1997-Broome,1997,Broome,6640,383,7023
1997-Cattaraugus,1997,Cattaraugus,2069,231,2300
1997-Cayuga,1997,Cayuga,1969,168,2137
1997-Chautauqua,1997,Chautauqua,4271,398,4669
1997-Chemung,1997,Chemung,3062,258,3320
1997-Chenango,1997,Chenango,1231,131,1362
1997-Clinton,1997,Clinton,1562,354,1916
1997-Columbia,1997,Columbia,1432,302,1734
1997-Cortland,1997,Cortland,1915,105,2020
1997-Delaware,1997,Delaware,865,104,969
1997-Dutchess,1997,Dutchess,6725,840,7565
1997-Erie,1997,Erie,39060,5100,44160
1997-Essex,1997,Essex,602,80,682
1997-Franklin,1997,Franklin,926,163,1089
1997-Fulton,1997,Fulton,1601,170,1771
1997-Genesee,1997,Genesee,1459,107,1566
1997-Greene,1997,Greene,932,337,1269
1997-Hamilton,1997,Hamilton,102,4,106
1997-Herkimer,1997,Herkimer,1352,154,1506
1997-Jefferson,1997,Jefferson,2534,166,2700
1997-Kings,1997,Kings,68757,32697,101454
1997-Lewis,1997,Lewis,352,41,393
1997-Livingston,1997,Livingston,1551,143,1694
1997-Madison,1997,Madison,1573,72,1645
1997-Monroe,1997,Monroe,33747,2912,36659
1997-Montgomery,1997,Montgomery,1039,123,1162
1997-Nassau,1997,Nassau,27258,2532,29790
1997-New York,1997,New York,80079,20174,100253
1997-Niagara,1997,Niagara,8273,1027,9300
1997-Oneida,1997,Oneida,6894,693,7587
1997-Onondaga,1997,Onondaga,17834,1791,19625
1997-Ontario,1997,Ontario,2247,72,2319
1997-Orange,1997,Orange,7934,1051,8985
1997-Orleans,1997,Orleans,989,91,1080
1997-Oswego,1997,Oswego,3283,156,3439
1997-Otsego,1997,Otsego,1329,124,1453
1997-Putnam,1997,Putnam,1236,60,1296
1997-Queens,1997,Queens,68062,17832,85894
1997-Rensselaer,1997,Rensselaer,4952,531,5483
1997-Richmond,1997,Richmond,8775,2571,11346
1997-Rockland,1997,Rockland,6691,746,7437
1997-Saratoga,1997,Saratoga,2915,237,3152
1997-Schenectady,1997,Schenectady,5175,501,5676
1997-Schoharie,1997,Schoharie,487,39,526
1997-Schuyler,1997,Schuyler,302,16,318
1997-Seneca,1997,Seneca,696,53,749
1997-St Lawrence,1997,St Lawrence,2960,206,3166
1997-Steuben,1997,Steuben,2721,216,2937
1997-Suffolk,1997,Suffolk,41752,2513,44265
1997-Sullivan,1997,Sullivan,2457,430,2887
1997-Tioga,1997,Tioga,580,47,627
1997-Tompkins,1997,Tompkins,3138,148,3286
1997-Ulster,1997,Ulster,4251,629,4880
1997-Warren,1997,Warren,1896,133,2029
1997-Washington,1997,Washington,1104,194,1298
1997-Wayne,1997,Wayne,2007,136,2143
1997-Westchester,1997,Westchester,25455,3146,28601
1997-Wyoming,1997,Wyoming,937,114,1051
1997-Yates,1997,Yates,452,35,487
1998-Albany,1998,Albany,12423,1310,13733
1998-Allegany,1998,Allegany,822,69,891
1998-Bronx,1998,Bronx,34073,18391,52464
1998-Broome,1998,Broome,6162,386,6548
1998-Cattaraugus,1998,Cattaraugus,1942,154,2096
1998-Cayuga,1998,Cayuga,1854,178,2032
1998-Chautauqua,1998,Chautauqua,4038,390,4428
1998-Chemung,1998,Chemung,2806,258,3064
1998-Chenango,1998,Chenango,943,136,1079
1998-Clinton,1998,Clinton,1124,249,1373
1998-Columbia,1998,Columbia,1255,247,1502
1998-Cortland,1998,Cortland,1740,125,1865
1998-Delaware,1998,Delaware,699,99,798
1998-Dutchess,1998,Dutchess,5955,680,6635
1998-Erie,1998,Erie,34790,4535,39325
1998-Essex,1998,Essex,560,86,646
1998-Franklin,1998,Franklin,674,173,847
1998-Fulton,1998,Fulton,1437,159,1596
1998-Genesee,1998,Genesee,1322,97,1419
1998-Greene,1998,Greene,821,326,1147
1998-Hamilton,1998,Hamilton,100,1,101
1998-Herkimer,1998,Herkimer,1305,141,1446
1998-Jefferson,1998,Jefferson,2154,173,2327
1998-Kings,1998,Kings,65324,31123,96447
1998-Lewis,1998,Lewis,312,157,469
1998-Livingston,1998,Livingston,1646,155,1801
1998-Madison,1998,Madison,1241,54,1295
1998-Monroe,1998,Monroe,32036,2394,34430
1998-Montgomery,1998,Montgomery,1041,106,1147
1998-Nassau,1998,Nassau,25117,2468,27585
1998-New York,1998,New York,71751,18054,89805
1998-Niagara,1998,Niagara,7832,930,8762
1998-Oneida,1998,Oneida,6607,630,7237
1998-Onondaga,1998,Onondaga,15989,1866,17855
1998-Ontario,1998,Ontario,2283,113,2396
1998-Orange,1998,Orange,7554,1079,8633
1998-Orleans,1998,Orleans,788,116,904
1998-Oswego,1998,Oswego,2767,118,2885
1998-Otsego,1998,Otsego,1039,132,1171
1998-Putnam,1998,Putnam,1219,70,1289
1998-Queens,1998,Queens,59173,16492,75665
1998-Rensselaer,1998,Rensselaer,4470,413,4883
1998-Richmond,1998,Richmond,7205,1855,9060
1998-Rockland,1998,Rockland,6302,710,7012
1998-Saratoga,1998,Saratoga,2802,209,3011
1998-Schenectady,1998,Schenectady,5057,563,5620
1998-Schoharie,1998,Schoharie,437,33,470
1998-Schuyler,1998,Schuyler,349,10,359
1998-Seneca,1998,Seneca,726,66,792
1998-St Lawrence,1998,St Lawrence,2819,189,3008
1998-Steuben,1998,Steuben,2547,178,2725
1998-Suffolk,1998,Suffolk,38786,2730,41516
1998-Sullivan,1998,Sullivan,2251,277,2528
1998-Tioga,1998,Tioga,718,33,751
1998-Tompkins,1998,Tompkins,2722,101,2823
1998-Ulster,1998,Ulster,3664,543,4207
1998-Warren,1998,Warren,1933,143,2076
1998-Washington,1998,Washington,1128,247,1375
1998-Wayne,1998,Wayne,2066,130,2196
1998-Westchester,1998,Westchester,22983,2994,25977
1998-Wyoming,1998,Wyoming,1058,108,1166
1998-Yates,1998,Yates,407,22,429
1999-Albany,1999,Albany,13012,1133,14145
1999-Allegany,1999,Allegany,665,94,759
1999-Bronx,1999,Bronx,33108,16820,49928
1999-Broome,1999,Broome,5663,386,6049
1999-Cattaraugus,1999,Cattaraugus,1540,176,1716
1999-Cayuga,1999,Cayuga,1817,179,1996
1999-Chautauqua,1999,Chautauqua,3486,311,3797
1999-Chemung,1999,Chemung,2651,275,2926
1999-Chenango,1999,Chenango,1009,153,1162
1999-Clinton,1999,Clinton,1228,214,1442
1999-Columbia,1999,Columbia,1162,200,1362
1999-Cortland,1999,Cortland,1606,86,1692
1999-Delaware,1999,Delaware,730,102,832
1999-Dutchess,1999,Dutchess,6015,603,6618
1999-Erie,1999,Erie,31728,4162,35890
1999-Essex,1999,Essex,538,111,649
1999-Franklin,1999,Franklin,751,177,928
1999-Fulton,1999,Fulton,1392,140,1532
1999-Genesee,1999,Genesee,1374,87,1461
1999-Greene,1999,Greene,891,219,1110
1999-Hamilton,1999,Hamilton,128,7,135
1999-Herkimer,1999,Herkimer,1293,157,1450
1999-Jefferson,1999,Jefferson,2061,165,2226
1999-Kings,1999,Kings,60428,28725,89153
1999-Lewis,1999,Lewis,255,29,284
1999-Livingston,1999,Livingston,1441,112,1553
1999-Madison,1999,Madison,1195,69,1264
1999-Monroe,1999,Monroe,28581,1943,30524
1999-Montgomery,1999,Montgomery,855,107,962
1999-Nassau,1999,Nassau,25603,2595,28198
1999-New York,1999,New York,65434,16179,81613
1999-Niagara,1999,Niagara,6657,734,7391
1999-Oneida,1999,Oneida,6065,523,6588
1999-Onondaga,1999,Onondaga,14478,1995,16473
1999-Ontario,1999,Ontario,2179,129,2308
1999-Orange,1999,Orange,7796,1005,8801
1999-Orleans,1999,Orleans,799,94,893
1999-Oswego,1999,Oswego,2637,126,2763
1999-Otsego,1999,Otsego,1206,167,1373
1999-Putnam,1999,Putnam,1154,66,1220
1999-Queens,1999,Queens,54898,15700,70598
1999-Rensselaer,1999,Rensselaer,4313,461,4774
1999-Richmond,1999,Richmond,7070,1547,8617
1999-Rockland,1999,Rockland,5968,739,6707
1999-Saratoga,1999,Saratoga,2717,218,2935
1999-Schenectady,1999,Schenectady,4855,570,5425
1999-Schoharie,1999,Schoharie,470,43,513
1999-Schuyler,1999,Schuyler,425,26,451
1999-Seneca,1999,Seneca,631,40,671
1999-St Lawrence,1999,St Lawrence,2651,197,2848
1999-Steuben,1999,Steuben,2241,186,2427
1999-Suffolk,1999,Suffolk,35013,2430,37443
1999-Sullivan,1999,Sullivan,1873,235,2108
1999-Tioga,1999,Tioga,571,43,614
1999-Tompkins,1999,Tompkins,2549,161,2710
1999-Ulster,1999,Ulster,3683,389,4072
1999-Warren,1999,Warren,1596,109,1705
1999-Washington,1999,Washington,929,193,1122
1999-Wayne,1999,Wayne,1844,109,1953
1999-Westchester,1999,Westchester,19970,2740,22710
1999-Wyoming,1999,Wyoming,918,105,1023
1999-Yates,1999,Yates,409,32,441
2000-Albany,2000,Albany,12743,1353,14096
2000-Allegany,2000,Allegany,821,143,964
2000-Bronx,2000,Bronx,33055,16482,49537
2000-Broome,2000,Broome,5623,420,6043
2000-Cattaraugus,2000,Cattaraugus,1687,194,1881
2000-Cayuga,2000,Cayuga,1724,175,1899
2000-Chautauqua,2000,Chautauqua,3659,287,3946
2000-Chemung,2000,Chemung,2590,271,2861
2000-Chenango,2000,Chenango,1070,103,1173
2000-Clinton,2000,Clinton,1176,239,1415
2000-Columbia,2000,Columbia,982,146,1128
2000-Cortland,2000,Cortland,1528,105,1633
2000-Delaware,2000,Delaware,597,104,701
2000-Dutchess,2000,Dutchess,5737,609,6346
2000-Erie,2000,Erie,30926,4545,35471
2000-Essex,2000,Essex,642,125,767
2000-Franklin,2000,Franklin,815,205,1020
2000-Fulton,2000,Fulton,1379,134,1513
2000-Genesee,2000,Genesee,1549,85,1634
2000-Greene,2000,Greene,735,153,888
2000-Hamilton,2000,Hamilton,116,7,123
2000-Herkimer,2000,Herkimer,1239,163,1402
2000-Jefferson,2000,Jefferson,1979,157,2136
2000-Kings,2000,Kings,58301,27611,85912
2000-Lewis,2000,Lewis,248,14,262
2000-Livingston,2000,Livingston,1464,88,1552
2000-Madison,2000,Madison,1267,90,1357
2000-Monroe,2000,Monroe,29845,2089,31934
2000-Montgomery,2000,Montgomery,881,107,988
2000-Nassau,2000,Nassau,23592,2389,25981
2000-New York,2000,New York,63696,15583,79279
2000-Niagara,2000,Niagara,6534,725,7259
2000-Oneida,2000,Oneida,5874,577,6451
2000-Onondaga,2000,Onondaga,14444,2001,16445
2000-Ontario,2000,Ontario,1869,107,1976
2000-Orange,2000,Orange,7741,1014,8755
2000-Orleans,2000,Orleans,632,57,689
2000-Oswego,2000,Oswego,2367,111,2478
2000-Otsego,2000,Otsego,898,134,1032
2000-Putnam,2000,Putnam,1018,53,1071
2000-Queens,2000,Queens,50313,14349,64662
2000-Rensselaer,2000,Rensselaer,4400,481,4881
2000-Richmond,2000,Richmond,6891,1714,8605
2000-Rockland,2000,Rockland,5374,635,6009
2000-Saratoga,2000,Saratoga,2763,263,3026
2000-Schenectady,2000,Schenectady,4726,559,5285
2000-Schoharie,2000,Schoharie,529,26,555
2000-Schuyler,2000,Schuyler,402,21,423
2000-Seneca,2000,Seneca,658,31,689
2000-St Lawrence,2000,St Lawrence,2574,234,2808
2000-Steuben,2000,Steuben,1912,137,2049
2000-Suffolk,2000,Suffolk,33362,3049,36411
2000-Sullivan,2000,Sullivan,1917,285,2202
2000-Tioga,2000,Tioga,473,34,507
2000-Tompkins,2000,Tompkins,2445,113,2558
2000-Ulster,2000,Ulster,3562,401,3963
2000-Warren,2000,Warren,1664,110,1774
2000-Washington,2000,Washington,905,206,1111
2000-Wayne,2000,Wayne,2030,121,2151
2000-Westchester,2000,Westchester,19410,2624,22034
2000-Wyoming,2000,Wyoming,1011,113,1124
2000-Yates,2000,Yates,322,26,348
2001-Albany,2001,Albany,12084,1649,13733
2001-Allegany,2001,Allegany,757,143,900
2001-Bronx,2001,Bronx,31574,14793,46367
2001-Broome,2001,Broome,5387,443,5830
2001-Cattaraugus,2001,Cattaraugus,1707,190,1897
2001-Cayuga,2001,Cayuga,1729,177,1906
2001-Chautauqua,2001,Chautauqua,3281,350,3631
2001-Chemung,2001,Chemung,2563,251,2814
2001-Chenango,2001,Chenango,1105,130,1235
2001-Clinton,2001,Clinton,1249,202,1451
2001-Columbia,2001,Columbia,958,116,1074
2001-Cortland,2001,Cortland,1486,101,1587
2001-Delaware,2001,Delaware,699,113,812
2001-Dutchess,2001,Dutchess,5491,627,6118
2001-Erie,2001,Erie,30610,4572,35182
2001-Essex,2001,Essex,661,58,719
2001-Franklin,2001,Franklin,819,199,1018
2001-Fulton,2001,Fulton,1383,93,1476
2001-Genesee,2001,Genesee,1489,96,1585
2001-Greene,2001,Greene,756,175,931
2001-Hamilton,2001,Hamilton,97,3,100
2001-Herkimer,2001,Herkimer,1170,171,1341
2001-Jefferson,2001,Jefferson,2038,174,2212
2001-Kings,2001,Kings,52605,25226,77831
2001-Lewis,2001,Lewis,272,44,316
2001-Livingston,2001,Livingston,1576,66,1642
2001-Madison,2001,Madison,1355,99,1454
2001-Monroe,2001,Monroe,28140,2096,30236
2001-Montgomery,2001,Montgomery,830,101,931
2001-Nassau,2001,Nassau,20406,2671,23077
2001-New York,2001,New York,58748,14248,72996
2001-Niagara,2001,Niagara,7213,733,7946
2001-Oneida,2001,Oneida,6124,602,6726
2001-Onondaga,2001,Onondaga,15486,2023,17509
2001-Ontario,2001,Ontario,1914,97,2011
2001-Orange,2001,Orange,7565,1036,8601
2001-Orleans,2001,Orleans,507,65,572
2001-Oswego,2001,Oswego,2878,116,2994
2001-Otsego,2001,Otsego,793,117,910
2001-Putnam,2001,Putnam,1008,91,1099
2001-Queens,2001,Queens,46347,12991,59338
2001-Rensselaer,2001,Rensselaer,4204,458,4662
2001-Richmond,2001,Richmond,6214,1479,7693
2001-Rockland,2001,Rockland,5380,719,6099
2001-Saratoga,2001,Saratoga,2903,265,3168
2001-Schenectady,2001,Schenectady,4859,619,5478
2001-Schoharie,2001,Schoharie,587,46,633
2001-Schuyler,2001,Schuyler,359,31,390
2001-Seneca,2001,Seneca,549,57,606
2001-St Lawrence,2001,St Lawrence,2301,225,2526
2001-Steuben,2001,Steuben,1905,120,2025
2001-Suffolk,2001,Suffolk,34329,3326,37655
2001-Sullivan,2001,Sullivan,1558,259,1817
2001-Tioga,2001,Tioga,511,31,542
2001-Tompkins,2001,Tompkins,2493,121,2614
2001-Ulster,2001,Ulster,3141,359,3500
2001-Warren,2001,Warren,1671,101,1772
2001-Washington,2001,Washington,765,195,960
2001-Wayne,2001,Wayne,1974,139,2113
2001-Westchester,2001,Westchester,18802,2789,21591
2001-Wyoming,2001,Wyoming,1083,102,1185
2001-Yates,2001,Yates,329,19,348
2002-Albany,2002,Albany,11078,1706,12784
2002-Allegany,2002,Allegany,746,116,862
2002-Bronx,2002,Bronx,29923,14112,44035
2002-Broome,2002,Broome,5820,468,6288
2002-Cattaraugus,2002,Cattaraugus,1887,215,2102
2002-Cayuga,2002,Cayuga,1679,165,1844
2002-Chautauqua,2002,Chautauqua,3236,339,3575
2002-Chemung,2002,Chemung,2727,308,3035
2002-Chenango,2002,Chenango,1166,117,1283
2002-Clinton,2002,Clinton,1321,231,1552
2002-Columbia,2002,Columbia,959,114,1073
2002-Cortland,2002,Cortland,1420,93,1513
2002-Delaware,2002,Delaware,801,135,936
2002-Dutchess,2002,Dutchess,5272,696,5968
2002-Erie,2002,Erie,27634,4635,32269
2002-Essex,2002,Essex,608,64,672
2002-Franklin,2002,Franklin,862,197,1059
2002-Fulton,2002,Fulton,1421,74,1495
2002-Genesee,2002,Genesee,1575,108,1683
2002-Greene,2002,Greene,664,146,810
2002-Hamilton,2002,Hamilton,103,7,110
2002-Herkimer,2002,Herkimer,1203,211,1414
2002-Jefferson,2002,Jefferson,1843,218,2061
2002-Kings,2002,Kings,51241,22466,73707
2002-Lewis,2002,Lewis,296,40,336
2002-Livingston,2002,Livingston,1535,79,1614
2002-Madison,2002,Madison,1289,77,1366
2002-Monroe,2002,Monroe,28240,2303,30543
2002-Montgomery,2002,Montgomery,713,86,799
2002-Nassau,2002,Nassau,20492,2707,23199
2002-New York,2002,New York,54941,13211,68152
2002-Niagara,2002,Niagara,7149,815,7964
2002-Oneida,2002,Oneida,6098,689,6787
2002-Onondaga,2002,Onondaga,15668,1967,17635
2002-Ontario,2002,Ontario,1965,102,2067
2002-Orange,2002,Orange,7482,1240,8722
2002-Orleans,2002,Orleans,554,95,649
2002-Oswego,2002,Oswego,2894,183,3077
2002-Otsego,2002,Otsego,991,159,1150
2002-Putnam,2002,Putnam,1209,73,1282
2002-Queens,2002,Queens,44264,12625,56889
2002-Rensselaer,2002,Rensselaer,4406,547,4953
2002-Richmond,2002,Richmond,6422,1426,7848
2002-Rockland,2002,Rockland,4760,649,5409
2002-Saratoga,2002,Saratoga,2598,262,2860
2002-Schenectady,2002,Schenectady,4594,563,5157
2002-Schoharie,2002,Schoharie,573,67,640
2002-Schuyler,2002,Schuyler,295,29,324
2002-Seneca,2002,Seneca,581,55,636
2002-St Lawrence,2002,St Lawrence,2259,264,2523
2002-Steuben,2002,Steuben,1295,122,1417
2002-Suffolk,2002,Suffolk,33583,3124,36707
2002-Sullivan,2002,Sullivan,1581,256,1837
2002-Tioga,2002,Tioga,572,38,610
2002-Tompkins,2002,Tompkins,2873,132,3005
2002-Ulster,2002,Ulster,3581,525,4106
2002-Warren,2002,Warren,1770,122,1892
2002-Washington,2002,Washington,910,213,1123
2002-Wayne,2002,Wayne,1885,135,2020
2002-Westchester,2002,Westchester,17373,2575,19948
2002-Wyoming,2002,Wyoming,1073,72,1145
2002-Yates,2002,Yates,359,30,389
2003-Albany,2003,Albany,10575,1402,11977
2003-Allegany,2003,Allegany,746,100,846
2003-Bronx,2003,Bronx,29690,13381,43071
2003-Broome,2003,Broome,5655,407,6062
2003-Cattaraugus,2003,Cattaraugus,2120,205,2325
2003-Cayuga,2003,Cayuga,1627,186,1813
2003-Chautauqua,2003,Chautauqua,3619,347,3966
2003-Chemung,2003,Chemung,2639,277,2916
2003-Chenango,2003,Chenango,1116,112,1228
2003-Clinton,2003,Clinton,1432,167,1599
2003-Columbia,2003,Columbia,823,64,887
2003-Cortland,2003,Cortland,1271,95,1366
2003-Delaware,2003,Delaware,826,111,937
2003-Dutchess,2003,Dutchess,5439,786,6225
2003-Erie,2003,Erie,29779,4843,34622
2003-Essex,2003,Essex,517,51,568
2003-Franklin,2003,Franklin,810,193,1003
2003-Fulton,2003,Fulton,1206,82,1288
2003-Genesee,2003,Genesee,1663,115,1778
2003-Greene,2003,Greene,566,152,718
2003-Hamilton,2003,Hamilton,68,3,71
2003-Herkimer,2003,Herkimer,1183,226,1409
2003-Jefferson,2003,Jefferson,1993,197,2190
2003-Kings,2003,Kings,49804,21485,71289
2003-Lewis,2003,Lewis,297,47,344
2003-Livingston,2003,Livingston,1678,95,1773
2003-Madison,2003,Madison,1184,82,1266
2003-Monroe,2003,Monroe,29065,2623,31688
2003-Montgomery,2003,Montgomery,648,46,694
2003-Nassau,2003,Nassau,20345,2598,22943
2003-New York,2003,New York,52277,12179,64456
2003-Niagara,2003,Niagara,6734,879,7613
2003-Oneida,2003,Oneida,5694,700,6394
2003-Onondaga,2003,Onondaga,14361,1762,16123
2003-Ontario,2003,Ontario,1985,118,2103
2003-Orange,2003,Orange,6970,932,7902
2003-Orleans,2003,Orleans,428,70,498
2003-Oswego,2003,Oswego,2396,142,2538
2003-Otsego,2003,Otsego,1045,133,1178
2003-Putnam,2003,Putnam,1109,79,1188
2003-Queens,2003,Queens,39336,11106,50442
2003-Rensselaer,2003,Rensselaer,4108,528,4636
2003-Richmond,2003,Richmond,5660,1297,6957
2003-Rockland,2003,Rockland,4392,554,4946
2003-Saratoga,2003,Saratoga,2432,197,2629
2003-Schenectady,2003,Schenectady,4234,554,4788
2003-Schoharie,2003,Schoharie,608,40,648
2003-Schuyler,2003,Schuyler,301,21,322
2003-Seneca,2003,Seneca,562,44,606
2003-St Lawrence,2003,St Lawrence,2363,216,2579
2003-Steuben,2003,Steuben,1390,126,1516
2003-Suffolk,2003,Suffolk,32416,2975,35391
2003-Sullivan,2003,Sullivan,1812,294,2106
2003-Tioga,2003,Tioga,568,32,600
2003-Tompkins,2003,Tompkins,2166,128,2294
2003-Ulster,2003,Ulster,3444,582,4026
2003-Warren,2003,Warren,1465,135,1600
2003-Washington,2003,Washington,831,185,1016
2003-Wayne,2003,Wayne,2110,145,2255
2003-Westchester,2003,Westchester,16882,2616,19498
2003-Wyoming,2003,Wyoming,926,80,1006
2003-Yates,2003,Yates,330,30,360
2004-Albany,2004,Albany,11279,1431,12710
2004-Allegany,2004,Allegany,846,97,943
2004-Bronx,2004,Bronx,28142,12797,40939
2004-Broome,2004,Broome,5581,328,5909
2004-Cattaraugus,2004,Cattaraugus,2270,211,2481
2004-Cayuga,2004,Cayuga,1639,131,1770
2004-Chautauqua,2004,Chautauqua,3457,347,3804
2004-Chemung,2004,Chemung,2817,253,3070
2004-Chenango,2004,Chenango,977,119,1096
2004-Clinton,2004,Clinton,1401,187,1588
2004-Columbia,2004,Columbia,1008,74,1082
2004-Cortland,2004,Cortland,1267,107,1374
2004-Delaware,2004,Delaware,756,88,844
2004-Dutchess,2004,Dutchess,4563,747,5310
2004-Erie,2004,Erie,28589,4715,33304
2004-Essex,2004,Essex,409,61,470
2004-Franklin,2004,Franklin,864,165,1029
2004-Fulton,2004,Fulton,1404,95,1499
2004-Genesee,2004,Genesee,1717,108,1825
2004-Greene,2004,Greene,663,140,803
2004-Hamilton,2004,Hamilton,53,4,57
2004-Herkimer,2004,Herkimer,1000,177,1177
2004-Jefferson,2004,Jefferson,2051,230,2281
2004-Kings,2004,Kings,48227,19735,67962
2004-Lewis,2004,Lewis,291,26,317
2004-Livingston,2004,Livingston,1639,86,1725
2004-Madison,2004,Madison,1333,71,1404
2004-Monroe,2004,Monroe,28615,2332,30947
2004-Montgomery,2004,Montgomery,670,56,726
2004-Nassau,2004,Nassau,19816,2501,22317
2004-New York,2004,New York,51317,11414,62731
2004-Niagara,2004,Niagara,6965,895,7860
2004-Oneida,2004,Oneida,5852,546,6398
2004-Onondaga,2004,Onondaga,12567,1674,14241
2004-Ontario,2004,Ontario,1718,88,1806
2004-Orange,2004,Orange,6430,930,7360
2004-Orleans,2004,Orleans,575,71,646
2004-Oswego,2004,Oswego,2496,136,2632
2004-Otsego,2004,Otsego,1077,129,1206
2004-Putnam,2004,Putnam,1012,77,1089
2004-Queens,2004,Queens,37819,10323,48142
2004-Rensselaer,2004,Rensselaer,3830,488,4318
2004-Richmond,2004,Richmond,5683,1419,7102
2004-Rockland,2004,Rockland,4661,571,5232
2004-Saratoga,2004,Saratoga,2603,248,2851
2004-Schenectady,2004,Schenectady,4805,613,5418
2004-Schoharie,2004,Schoharie,478,45,523
2004-Schuyler,2004,Schuyler,335,12,347
2004-Seneca,2004,Seneca,549,37,586
2004-St Lawrence,2004,St Lawrence,2500,144,2644
2004-Steuben,2004,Steuben,1905,188,2093
2004-Suffolk,2004,Suffolk,29172,2844,32016
2004-Sullivan,2004,Sullivan,1607,273,1880
2004-Tioga,2004,Tioga,517,29,546
2004-Tompkins,2004,Tompkins,2147,116,2263
2004-Ulster,2004,Ulster,3438,467,3905
2004-Warren,2004,Warren,1359,98,1457
2004-Washington,2004,Washington,688,86,774
2004-Wayne,2004,Wayne,1985,197,2182
2004-Westchester,2004,Westchester,16021,2601,18622
2004-Wyoming,2004,Wyoming,623,58,681
2004-Yates,2004,Yates,296,30,326
2005-Albany,2005,Albany,10504,1615,12119
2005-Allegany,2005,Allegany,935,134,1069
2005-Bronx,2005,Bronx,26699,12325,39024
2005-Broome,2005,Broome,5720,409,6129
2005-Cattaraugus,2005,Cattaraugus,2194,200,2394
2005-Cayuga,2005,Cayuga,1710,138,1848
2005-Chautauqua,2005,Chautauqua,3613,390,4003
2005-Chemung,2005,Chemung,2602,211,2813
2005-Chenango,2005,Chenango,999,104,1103
2005-Clinton,2005,Clinton,1838,173,2011
2005-Columbia,2005,Columbia,1009,89,1098
2005-Cortland,2005,Cortland,1266,130,1396
2005-Delaware,2005,Delaware,665,82,747
2005-Dutchess,2005,Dutchess,5197,826,6023
2005-Erie,2005,Erie,29441,5017,34458
2005-Essex,2005,Essex,496,53,549
2005-Franklin,2005,Franklin,712,155,867
2005-Fulton,2005,Fulton,1498,109,1607
2005-Genesee,2005,Genesee,1597,96,1693
2005-Greene,2005,Greene,695,133,828
2005-Hamilton,2005,Hamilton,81,3,84
2005-Herkimer,2005,Herkimer,1258,210,1468
2005-Jefferson,2005,Jefferson,2771,290,3061
2005-Kings,2005,Kings,46870,19369,66239
2005-Lewis,2005,Lewis,338,28,366
2005-Livingston,2005,Livingston,1836,66,1902
2005-Madison,2005,Madison,1215,83,1298
2005-Monroe,2005,Monroe,25044,2735,27779
2005-Montgomery,2005,Montgomery,753,122,875
2005-Nassau,2005,Nassau,18195,2565,20760
2005-New York,2005,New York,48502,11180,59682
2005-Niagara,2005,Niagara,6327,970,7297
2005-Oneida,2005,Oneida,5787,514,6301
2005-Onondaga,2005,Onondaga,11937,1969,13906
2005-Ontario,2005,Ontario,1615,110,1725
2005-Orange,2005,Orange,7193,976,8169
2005-Orleans,2005,Orleans,637,108,745
2005-Oswego,2005,Oswego,2472,187,2659
2005-Otsego,2005,Otsego,1084,112,1196
2005-Putnam,2005,Putnam,1017,95,1112
2005-Queens,2005,Queens,34872,10250,45122
2005-Rensselaer,2005,Rensselaer,3931,490,4421
2005-Richmond,2005,Richmond,5566,1499,7065
2005-Rockland,2005,Rockland,4217,541,4758
2005-Saratoga,2005,Saratoga,2601,269,2870
2005-Schenectady,2005,Schenectady,5056,708,5764
2005-Schoharie,2005,Schoharie,465,33,498
2005-Schuyler,2005,Schuyler,311,30,341
2005-Seneca,2005,Seneca,550,37,587
2005-St Lawrence,2005,St Lawrence,2499,174,2673
2005-Steuben,2005,Steuben,1951,202,2153
2005-Suffolk,2005,Suffolk,28983,3109,32092
2005-Sullivan,2005,Sullivan,1961,260,2221
2005-Tioga,2005,Tioga,484,29,513
2005-Tompkins,2005,Tompkins,2665,147,2812
2005-Ulster,2005,Ulster,3504,558,4062
2005-Warren,2005,Warren,1477,89,1566
2005-Washington,2005,Washington,812,97,909
2005-Wayne,2005,Wayne,2047,171,2218
2005-Westchester,2005,Westchester,14697,2648,17345
2005-Wyoming,2005,Wyoming,621,83,704
2005-Yates,2005,Yates,283,19,302
2006-Albany,2006,Albany,10390,1545,11935
2006-Allegany,2006,Allegany,720,119,839
2006-Bronx,2006,Bronx,24733,11922,36655
2006-Broome,2006,Broome,6121,504,6625
2006-Cattaraugus,2006,Cattaraugus,2074,165,2239
2006-Cayuga,2006,Cayuga,1784,176,1960
2006-Chautauqua,2006,Chautauqua,3322,330,3652
2006-Chemung,2006,Chemung,2387,193,2580
2006-Chenango,2006,Chenango,1012,96,1108
2006-Clinton,2006,Clinton,1677,128,1805
2006-Columbia,2006,Columbia,1198,125,1323
2006-Cortland,2006,Cortland,1057,112,1169
2006-Delaware,2006,Delaware,727,78,805
2006-Dutchess,2006,Dutchess,5119,854,5973
2006-Erie,2006,Erie,27566,5015,32581
2006-Essex,2006,Essex,497,55,552
2006-Franklin,2006,Franklin,808,157,965
2006-Fulton,2006,Fulton,1417,100,1517
2006-Genesee,2006,Genesee,1648,106,1754
2006-Greene,2006,Greene,786,183,969
2006-Hamilton,2006,Hamilton,68,6,74
2006-Herkimer,2006,Herkimer,1130,218,1348
2006-Jefferson,2006,Jefferson,2793,300,3093
2006-Kings,2006,Kings,43376,17992,61368
2006-Lewis,2006,Lewis,322,26,348
2006-Livingston,2006,Livingston,1871,92,1963
2006-Madison,2006,Madison,1159,66,1225
2006-Monroe,2006,Monroe,24409,3273,27682
2006-Montgomery,2006,Montgomery,684,131,815
2006-Nassau,2006,Nassau,18653,2578,21231
2006-New York,2006,New York,45593,10662,56255
2006-Niagara,2006,Niagara,6220,900,7120
2006-Oneida,2006,Oneida,5705,664,6369
2006-Onondaga,2006,Onondaga,12319,1885,14204
2006-Ontario,2006,Ontario,1759,130,1889
2006-Orange,2006,Orange,7380,971,8351
2006-Orleans,2006,Orleans,851,89,940
2006-Oswego,2006,Oswego,2578,158,2736
2006-Otsego,2006,Otsego,1046,146,1192
2006-Putnam,2006,Putnam,870,93,963
2006-Queens,2006,Queens,34006,10102,44108
2006-Rensselaer,2006,Rensselaer,4136,559,4695
2006-Richmond,2006,Richmond,5728,1408,7136
2006-Rockland,2006,Rockland,4239,507,4746
2006-Saratoga,2006,Saratoga,3043,244,3287
2006-Schenectady,2006,Schenectady,5386,799,6185
2006-Schoharie,2006,Schoharie,451,28,479
2006-Schuyler,2006,Schuyler,201,12,213
2006-Seneca,2006,Seneca,544,46,590
2006-St Lawrence,2006,St Lawrence,2541,158,2699
2006-Steuben,2006,Steuben,1511,259,1770
2006-Suffolk,2006,Suffolk,29496,3100,32596
2006-Sullivan,2006,Sullivan,1713,291,2004
2006-Tioga,2006,Tioga,550,37,587
2006-Tompkins,2006,Tompkins,2573,147,2720
2006-Ulster,2006,Ulster,3407,512,3919
2006-Warren,2006,Warren,1705,112,1817
2006-Washington,2006,Washington,977,96,1073
2006-Wayne,2006,Wayne,2102,165,2267
2006-Westchester,2006,Westchester,14910,2768,17678
2006-Wyoming,2006,Wyoming,653,100,753
2006-Yates,2006,Yates,350,23,373
2007-Albany,2007,Albany,9116,1468,10584
2007-Allegany,2007,Allegany,624,86,710
2007-Bronx,2007,Bronx,24364,11689,36053
2007-Broome,2007,Broome,5564,459,6023
2007-Cattaraugus,2007,Cattaraugus,1965,149,2114
2007-Cayuga,2007,Cayuga,1675,172,1847
2007-Chautauqua,2007,Chautauqua,3464,341,3805
2007-Chemung,2007,Chemung,2382,224,2606
2007-Chenango,2007,Chenango,923,47,970
2007-Clinton,2007,Clinton,1794,221,2015
2007-Columbia,2007,Columbia,1213,149,1362
2007-Cortland,2007,Cortland,1169,116,1285
2007-Delaware,2007,Delaware,757,91,848
2007-Dutchess,2007,Dutchess,5526,895,6421
2007-Erie,2007,Erie,28708,4541,33249
2007-Essex,2007,Essex,460,80,540
2007-Franklin,2007,Franklin,852,145,997
2007-Fulton,2007,Fulton,1483,132,1615
2007-Genesee,2007,Genesee,1354,87,1441
2007-Greene,2007,Greene,964,176,1140
2007-Hamilton,2007,Hamilton,52,2,54
2007-Herkimer,2007,Herkimer,1014,177,1191
2007-Jefferson,2007,Jefferson,2247,288,2535
2007-Kings,2007,Kings,41795,17526,59321
2007-Lewis,2007,Lewis,344,65,409
2007-Livingston,2007,Livingston,1500,61,1561
2007-Madison,2007,Madison,1360,74,1434
2007-Monroe,2007,Monroe,22322,2956,25278
2007-Montgomery,2007,Montgomery,606,118,724
2007-Nassau,2007,Nassau,17679,2341,20020
2007-New York,2007,New York,45043,10055,55098
2007-Niagara,2007,Niagara,6192,763,6955
2007-Oneida,2007,Oneida,6215,700,6915
2007-Onondaga,2007,Onondaga,11445,1815,13260
2007-Ontario,2007,Ontario,1715,99,1814
2007-Orange,2007,Orange,7739,1042,8781
2007-Orleans,2007,Orleans,1000,91,1091
2007-Oswego,2007,Oswego,2481,160,2641
2007-Otsego,2007,Otsego,1085,100,1185
2007-Putnam,2007,Putnam,912,71,983
2007-Queens,2007,Queens,32784,9846,42630
2007-Rensselaer,2007,Rensselaer,4044,495,4539
2007-Richmond,2007,Richmond,5502,1337,6839
2007-Rockland,2007,Rockland,3932,545,4477
2007-Saratoga,2007,Saratoga,2828,205,3033
2007-Schenectady,2007,Schenectady,4666,689,5355
2007-Schoharie,2007,Schoharie,534,33,567
2007-Schuyler,2007,Schuyler,148,19,167
2007-Seneca,2007,Seneca,519,46,565
2007-St Lawrence,2007,St Lawrence,2122,196,2318
2007-Steuben,2007,Steuben,1391,160,1551
2007-Suffolk,2007,Suffolk,28717,2657,31374
2007-Sullivan,2007,Sullivan,1799,268,2067
2007-Tioga,2007,Tioga,498,35,533
2007-Tompkins,2007,Tompkins,2336,116,2452
2007-Ulster,2007,Ulster,3018,455,3473
2007-Warren,2007,Warren,1520,109,1629
2007-Washington,2007,Washington,875,128,1003
2007-Wayne,2007,Wayne,1622,162,1784
2007-Westchester,2007,Westchester,14308,2478,16786
2007-Wyoming,2007,Wyoming,587,54,641
2007-Yates,2007,Yates,324,13,337
2008-Albany,2008,Albany,9394,1356,10750
2008-Allegany,2008,Allegany,560,91,651
2008-Bronx,2008,Bronx,23939,11345,35284
2008-Broome,2008,Broome,6308,555,6863
2008-Cattaraugus,2008,Cattaraugus,1715,215,1930
2008-Cayuga,2008,Cayuga,1706,147,1853
2008-Chautauqua,2008,Chautauqua,3414,320,3734
2008-Chemung,2008,Chemung,2133,204,2337
2008-Chenango,2008,Chenango,893,41,934
2008-Clinton,2008,Clinton,1677,142,1819
2008-Columbia,2008,Columbia,1199,137,1336
2008-Cortland,2008,Cortland,994,112,1106
2008-Delaware,2008,Delaware,664,74,738
2008-Dutchess,2008,Dutchess,5645,892,6537
2008-Erie,2008,Erie,28640,4735,33375
2008-Essex,2008,Essex,416,51,467
2008-Franklin,2008,Franklin,908,95,1003
2008-Fulton,2008,Fulton,1388,99,1487
2008-Genesee,2008,Genesee,1333,113,1446
2008-Greene,2008,Greene,1316,102,1418
2008-Hamilton,2008,Hamilton,36,5,41
2008-Herkimer,2008,Herkimer,1084,201,1285
2008-Jefferson,2008,Jefferson,2500,271,2771
2008-Kings,2008,Kings,42652,16895,59547
2008-Lewis,2008,Lewis,349,35,384
2008-Livingston,2008,Livingston,1003,72,1075
2008-Madison,2008,Madison,1391,70,1461
2008-Monroe,2008,Monroe,21987,2917,24904
2008-Montgomery,2008,Montgomery,651,134,785
2008-Nassau,2008,Nassau,18766,2309,21075
2008-New York,2008,New York,45555,9176,54731
2008-Niagara,2008,Niagara,6404,763,7167
2008-Oneida,2008,Oneida,5938,672,6610
2008-Onondaga,2008,Onondaga,11732,1728,13460
2008-Ontario,2008,Ontario,1789,108,1897
2008-Orange,2008,Orange,8145,1039,9184
2008-Orleans,2008,Orleans,1034,73,1107
2008-Oswego,2008,Oswego,2409,184,2593
2008-Otsego,2008,Otsego,1016,86,1102
2008-Putnam,2008,Putnam,969,83,1052
2008-Queens,2008,Queens,31660,9689,41349
2008-Rensselaer,2008,Rensselaer,4223,547,4770
2008-Richmond,2008,Richmond,6183,1325,7508
2008-Rockland,2008,Rockland,4505,542,5047
2008-Saratoga,2008,Saratoga,2979,161,3140
2008-Schenectady,2008,Schenectady,4903,740,5643
2008-Schoharie,2008,Schoharie,583,22,605
2008-Schuyler,2008,Schuyler,192,15,207
2008-Seneca,2008,Seneca,619,46,665
2008-St Lawrence,2008,St Lawrence,2117,210,2327
2008-Steuben,2008,Steuben,1337,161,1498
2008-Suffolk,2008,Suffolk,31402,2613,34015
2008-Sullivan,2008,Sullivan,1611,195,1806
2008-Tioga,2008,Tioga,544,36,580
2008-Tompkins,2008,Tompkins,2338,137,2475
2008-Ulster,2008,Ulster,3211,459,3670
2008-Warren,2008,Warren,1503,111,1614
2008-Washington,2008,Washington,792,119,911
2008-Wayne,2008,Wayne,1823,185,2008
2008-Westchester,2008,Westchester,14309,2414,16723
2008-Wyoming,2008,Wyoming,495,52,547
2008-Yates,2008,Yates,269,15,284
2009-Albany,2009,Albany,9324,1289,10613
2009-Allegany,2009,Allegany,647,129,776
2009-Bronx,2009,Bronx,22513,11242,33755
2009-Broome,2009,Broome,5713,458,6171
2009-Cattaraugus,2009,Cattaraugus,1671,184,1855
2009-Cayuga,2009,Cayuga,1474,186,1660
2009-Chautauqua,2009,Chautauqua,3341,256,3597
2009-Chemung,2009,Chemung,1965,161,2126
2009-Chenango,2009,Chenango,944,53,997
2009-Clinton,2009,Clinton,1565,133,1698
2009-Columbia,2009,Columbia,1067,113,1180
2009-Cortland,2009,Cortland,978,106,1084
2009-Delaware,2009,Delaware,685,69,754
2009-Dutchess,2009,Dutchess,5186,909,6095
2009-Erie,2009,Erie,27741,4915,32656
2009-Essex,2009,Essex,471,49,520
2009-Franklin,2009,Franklin,872,65,937
2009-Fulton,2009,Fulton,1410,112,1522
2009-Genesee,2009,Genesee,1405,92,1497
2009-Greene,2009,Greene,749,102,851
2009-Hamilton,2009,Hamilton,49,2,51
2009-Herkimer,2009,Herkimer,1201,168,1369
2009-Jefferson,2009,Jefferson,2477,224,2701
2009-Kings,2009,Kings,40013,15803,55816
2009-Lewis,2009,Lewis,364,23,387
2009-Livingston,2009,Livingston,929,69,998
2009-Madison,2009,Madison,1261,59,1320
2009-Monroe,2009,Monroe,23258,2598,25856
2009-Montgomery,2009,Montgomery,595,131,726
2009-Nassau,2009,Nassau,19332,2496,21828
2009-New York,2009,New York,44189,8710,52899
2009-Niagara,2009,Niagara,6326,847,7173
2009-Oneida,2009,Oneida,5921,644,6565
2009-Onondaga,2009,Onondaga,11722,1675,13397
2009-Ontario,2009,Ontario,1731,139,1870
2009-Orange,2009,Orange,7824,942,8766
2009-Orleans,2009,Orleans,1195,71,1266
2009-Oswego,2009,Oswego,2613,176,2789
2009-Otsego,2009,Otsego,1061,140,1201
2009-Putnam,2009,Putnam,878,85,963
2009-Queens,2009,Queens,29626,9299,38925
2009-Rensselaer,2009,Rensselaer,4296,513,4809
2009-Richmond,2009,Richmond,5659,1303,6962
2009-Rockland,2009,Rockland,4515,473,4988
2009-Saratoga,2009,Saratoga,2750,173,2923
2009-Schenectady,2009,Schenectady,5178,652,5830
2009-Schoharie,2009,Schoharie,545,27,572
2009-Schuyler,2009,Schuyler,156,18,174
2009-Seneca,2009,Seneca,603,48,651
2009-St Lawrence,2009,St Lawrence,1624,194,1818
2009-Steuben,2009,Steuben,1267,134,1401
2009-Suffolk,2009,Suffolk,29864,2740,32604
2009-Sullivan,2009,Sullivan,1358,186,1544
2009-Tioga,2009,Tioga,525,30,555
2009-Tompkins,2009,Tompkins,2405,153,2558
2009-Ulster,2009,Ulster,3453,445,3898
2009-Warren,2009,Warren,1367,77,1444
2009-Washington,2009,Washington,709,60,769
2009-Wayne,2009,Wayne,1634,140,1774
2009-Westchester,2009,Westchester,14154,2482,16636
2009-Wyoming,2009,Wyoming,453,47,500
2009-Yates,2009,Yates,339,11,350
2010-Albany,2010,Albany,9854,1182,11036
2010-Allegany,2010,Allegany,752,89,841
2010-Bronx,2010,Bronx,21938,12070,34008
2010-Broome,2010,Broome,5708,499,6207
2010-Cattaraugus,2010,Cattaraugus,1838,181,2019
2010-Cayuga,2010,Cayuga,1607,158,1765
2010-Chautauqua,2010,Chautauqua,3553,312,3865
2010-Chemung,2010,Chemung,1877,203,2080
2010-Chenango,2010,Chenango,929,54,983
2010-Clinton,2010,Clinton,1743,87,1830
2010-Columbia,2010,Columbia,1119,94,1213
2010-Cortland,2010,Cortland,1001,65,1066
2010-Delaware,2010,Delaware,703,62,765
2010-Dutchess,2010,Dutchess,5213,724,5937
2010-Erie,2010,Erie,28040,4528,32568
2010-Essex,2010,Essex,486,37,523
2010-Franklin,2010,Franklin,886,57,943
2010-Fulton,2010,Fulton,1566,123,1689
2010-Genesee,2010,Genesee,1355,107,1462
2010-Greene,2010,Greene,744,92,836
2010-Hamilton,2010,Hamilton,48,4,52
2010-Herkimer,2010,Herkimer,1205,169,1374
2010-Jefferson,2010,Jefferson,2214,220,2434
2010-Kings,2010,Kings,40658,16514,57172
2010-Lewis,2010,Lewis,437,25,462
2010-Livingston,2010,Livingston,1110,47,1157
2010-Madison,2010,Madison,1242,53,1295
2010-Monroe,2010,Monroe,23363,2823,26186
2010-Montgomery,2010,Montgomery,1091,72,1163
2010-Nassau,2010,Nassau,17976,2344,20320
2010-New York,2010,New York,42468,8829,51297
2010-Niagara,2010,Niagara,6374,835,7209
2010-Oneida,2010,Oneida,5651,587,6238
2010-Onondaga,2010,Onondaga,11397,1608,13005
2010-Ontario,2010,Ontario,1867,128,1995
2010-Orange,2010,Orange,8083,996,9079
2010-Orleans,2010,Orleans,984,79,1063
2010-Oswego,2010,Oswego,3099,189,3288
2010-Otsego,2010,Otsego,1019,126,1145
2010-Putnam,2010,Putnam,865,69,934
2010-Queens,2010,Queens,29083,9725,38808
2010-Rensselaer,2010,Rensselaer,4307,546,4853
2010-Richmond,2010,Richmond,5468,1351,6819
2010-Rockland,2010,Rockland,4306,460,4766
2010-Saratoga,2010,Saratoga,3085,151,3236
2010-Schenectady,2010,Schenectady,5273,748,6021
2010-Schoharie,2010,Schoharie,450,17,467
2010-Schuyler,2010,Schuyler,187,11,198
2010-Seneca,2010,Seneca,608,52,660
2010-St Lawrence,2010,St Lawrence,2341,141,2482
2010-Steuben,2010,Steuben,1673,164,1837
2010-Suffolk,2010,Suffolk,30261,2377,32638
2010-Sullivan,2010,Sullivan,1489,219,1708
2010-Tioga,2010,Tioga,564,36,600
2010-Tompkins,2010,Tompkins,2385,120,2505
2010-Ulster,2010,Ulster,3431,408,3839
2010-Warren,2010,Warren,1198,99,1297
2010-Washington,2010,Washington,791,93,884
2010-Wayne,2010,Wayne,1797,169,1966
2010-Westchester,2010,Westchester,12935,2457,15392
2010-Wyoming,2010,Wyoming,443,33,476
2010-Yates,2010,Yates,456,18,474
2011-Albany,2011,Albany,9562,1164,10726
2011-Allegany,2011,Allegany,831,64,895
2011-Bronx,2011,Bronx,22863,12267,35130
2011-Broome,2011,Broome,6122,521,6643
2011-Cattaraugus,2011,Cattaraugus,1763,162,1925
2011-Cayuga,2011,Cayuga,1535,182,1717
2011-Chautauqua,2011,Chautauqua,3384,303,3687
2011-Chemung,2011,Chemung,2101,177,2278
2011-Chenango,2011,Chenango,1015,57,1072
2011-Clinton,2011,Clinton,1616,74,1690
2011-Columbia,2011,Columbia,1138,96,1234
2011-Cortland,2011,Cortland,1030,74,1104
2011-Delaware,2011,Delaware,737,76,813
2011-Dutchess,2011,Dutchess,5052,625,5677
2011-Erie,2011,Erie,27210,4201,31411
2011-Essex,2011,Essex,570,47,617
2011-Franklin,2011,Franklin,912,61,973
2011-Fulton,2011,Fulton,1544,61,1605
2011-Genesee,2011,Genesee,1327,112,1439
2011-Greene,2011,Greene,726,105,831
2011-Hamilton,2011,Hamilton,57,1,58
2011-Herkimer,2011,Herkimer,1221,141,1362
2011-Jefferson,2011,Jefferson,2299,182,2481
2011-Kings,2011,Kings,40832,18182,59014
2011-Lewis,2011,Lewis,386,33,419
2011-Livingston,2011,Livingston,1030,44,1074
2011-Madison,2011,Madison,1231,53,1284
2011-Monroe,2011,Monroe,23005,2661,25666
2011-Montgomery,2011,Montgomery,1025,59,1084
2011-Nassau,2011,Nassau,17148,2226,19374
2011-New York,2011,New York,41837,9021,50858
2011-Niagara,2011,Niagara,6422,810,7232
2011-Oneida,2011,Oneida,5388,551,5939
2011-Onondaga,2011,Onondaga,11206,1656,12862
2011-Ontario,2011,Ontario,1953,150,2103
2011-Orange,2011,Orange,7992,1016,9008
2011-Orleans,2011,Orleans,922,81,1003
2011-Oswego,2011,Oswego,3036,181,3217
2011-Otsego,2011,Otsego,1027,119,1146
2011-Putnam,2011,Putnam,794,66,860
2011-Queens,2011,Queens,29552,10311,39863
2011-Rensselaer,2011,Rensselaer,4202,485,4687
2011-Richmond,2011,Richmond,5373,1428,6801
2011-Rockland,2011,Rockland,4013,554,4567
2011-Saratoga,2011,Saratoga,2943,132,3075
2011-Schenectady,2011,Schenectady,4842,687,5529
2011-Schoharie,2011,Schoharie,418,15,433
2011-Schuyler,2011,Schuyler,154,18,172
2011-Seneca,2011,Seneca,618,63,681
2011-St Lawrence,2011,St Lawrence,2372,143,2515
2011-Steuben,2011,Steuben,1549,138,1687
2011-Suffolk,2011,Suffolk,29189,2217,31406
2011-Sullivan,2011,Sullivan,1739,201,1940
2011-Tioga,2011,Tioga,557,34,591
2011-Tompkins,2011,Tompkins,2299,90,2389
2011-Ulster,2011,Ulster,3437,335,3772
2011-Warren,2011,Warren,1387,107,1494
2011-Washington,2011,Washington,770,96,866
2011-Wayne,2011,Wayne,1568,141,1709
2011-Westchester,2011,Westchester,13726,2557,16283
2011-Wyoming,2011,Wyoming,491,37,528
2011-Yates,2011,Yates,397,13,410
2012-Albany,2012,Albany,8963,1012,9975
2012-Allegany,2012,Allegany,791,65,856
2012-Bronx,2012,Bronx,23161,12801,35962
2012-Broome,2012,Broome,6293,604,6897
2012-Cattaraugus,2012,Cattaraugus,1938,149,2087
2012-Cayuga,2012,Cayuga,1667,141,1808
2012-Chautauqua,2012,Chautauqua,3539,308,3847
2012-Chemung,2012,Chemung,2212,222,2434
2012-Chenango,2012,Chenango,965,58,1023
2012-Clinton,2012,Clinton,1595,90,1685
2012-Columbia,2012,Columbia,1325,100,1425
2012-Cortland,2012,Cortland,1041,64,1105
2012-Delaware,2012,Delaware,700,63,763
2012-Dutchess,2012,Dutchess,5222,678,5900
2012-Erie,2012,Erie,27241,4227,31468
2012-Essex,2012,Essex,474,43,517
2012-Franklin,2012,Franklin,985,57,1042
2012-Fulton,2012,Fulton,1507,52,1559
2012-Genesee,2012,Genesee,1361,92,1453
2012-Greene,2012,Greene,633,88,721
2012-Hamilton,2012,Hamilton,80,1,81
2012-Herkimer,2012,Herkimer,1185,124,1309
2012-Jefferson,2012,Jefferson,2704,213,2917
2012-Kings,2012,Kings,42017,18673,60690
2012-Lewis,2012,Lewis,401,19,420
2012-Livingston,2012,Livingston,1141,54,1195
2012-Madison,2012,Madison,1278,59,1337
2012-Monroe,2012,Monroe,22738,2672,25410
2012-Montgomery,2012,Montgomery,1127,58,1185
2012-Nassau,2012,Nassau,17117,2458,19575
2012-New York,2012,New York,42654,9102,51756
2012-Niagara,2012,Niagara,6135,819,6954
2012-Oneida,2012,Oneida,5794,595,6389
2012-Onondaga,2012,Onondaga,11893,1752,13645
2012-Ontario,2012,Ontario,2025,150,2175
2012-Orange,2012,Orange,8422,1077,9499
2012-Orleans,2012,Orleans,859,61,920
2012-Oswego,2012,Oswego,3122,206,3328
2012-Otsego,2012,Otsego,905,78,983
2012-Putnam,2012,Putnam,834,41,875
2012-Queens,2012,Queens,29446,10753,40199
2012-Rensselaer,2012,Rensselaer,4200,447,4647
2012-Richmond,2012,Richmond,5482,1664,7146
2012-Rockland,2012,Rockland,3824,501,4325
2012-Saratoga,2012,Saratoga,3088,153,3241
2012-Schenectady,2012,Schenectady,4901,691,5592
2012-Schoharie,2012,Schoharie,475,19,494
2012-Schuyler,2012,Schuyler,164,21,185
2012-Seneca,2012,Seneca,794,59,853
2012-St Lawrence,2012,St Lawrence,2119,122,2241
2012-Steuben,2012,Steuben,1681,156,1837
2012-Suffolk,2012,Suffolk,26758,2127,28885
2012-Sullivan,2012,Sullivan,1750,181,1931
2012-Tioga,2012,Tioga,632,35,667
2012-Tompkins,2012,Tompkins,2630,116,2746
2012-Ulster,2012,Ulster,3664,279,3943
2012-Warren,2012,Warren,1305,125,1430
2012-Washington,2012,Washington,892,78,970
2012-Wayne,2012,Wayne,1711,132,1843
2012-Westchester,2012,Westchester,12592,2448,15040
2012-Wyoming,2012,Wyoming,501,51,552
2012-Yates,2012,Yates,408,20,428
2013-Albany,2013,Albany,8451,1006,9457
2013-Allegany,2013,Allegany,742,54,796
2013-Bronx,2013,Bronx,23260,13020,36280
2013-Broome,2013,Broome,6194,512,6706
2013-Cattaraugus,2013,Cattaraugus,1652,115,1767
2013-Cayuga,2013,Cayuga,1389,128,1517
2013-Chautauqua,2013,Chautauqua,3363,274,3637
2013-Chemung,2013,Chemung,2050,151,2201
2013-Chenango,2013,Chenango,878,48,926
2013-Clinton,2013,Clinton,1555,111,1666
2013-Columbia,2013,Columbia,1051,76,1127
2013-Cortland,2013,Cortland,1013,51,1064
2013-Delaware,2013,Delaware,750,56,806
2013-Dutchess,2013,Dutchess,4537,584,5121
2013-Erie,2013,Erie,25206,4089,29295
2013-Essex,2013,Essex,406,43,449
2013-Franklin,2013,Franklin,815,61,876
2013-Fulton,2013,Fulton,1465,62,1527
2013-Genesee,2013,Genesee,1358,109,1467
2013-Greene,2013,Greene,660,58,718
2013-Hamilton,2013,Hamilton,58,4,62
2013-Herkimer,2013,Herkimer,1064,126,1190
2013-Jefferson,2013,Jefferson,2262,140,2402
2013-Kings,2013,Kings,40798,18258,59056
2013-Lewis,2013,Lewis,308,24,332
2013-Livingston,2013,Livingston,1032,56,1088
2013-Madison,2013,Madison,1101,55,1156
2013-Monroe,2013,Monroe,20390,2686,23076
2013-Montgomery,2013,Montgomery,1077,48,1125
2013-Nassau,2013,Nassau,16573,2111,18684
2013-New York,2013,New York,43164,8708,51872
2013-Niagara,2013,Niagara,5856,798,6654
2013-Oneida,2013,Oneida,5452,537,5989
2013-Onondaga,2013,Onondaga,12496,1491,13987
2013-Ontario,2013,Ontario,1972,122,2094
2013-Orange,2013,Orange,7725,868,8593
2013-Orleans,2013,Orleans,688,59,747
2013-Oswego,2013,Oswego,2520,158,2678
2013-Otsego,2013,Otsego,770,65,835
2013-Putnam,2013,Putnam,723,49,772
2013-Queens,2013,Queens,29173,10740,39913
2013-Rensselaer,2013,Rensselaer,3666,471,4137
2013-Richmond,2013,Richmond,5576,1658,7234
2013-Rockland,2013,Rockland,3411,395,3806
2013-Saratoga,2013,Saratoga,2942,173,3115
2013-Schenectady,2013,Schenectady,4703,674,5377
2013-Schoharie,2013,Schoharie,509,27,536
2013-Schuyler,2013,Schuyler,151,14,165
2013-Seneca,2013,Seneca,732,62,794
2013-St Lawrence,2013,St Lawrence,1853,112,1965
2013-Steuben,2013,Steuben,1410,123,1533
2013-Suffolk,2013,Suffolk,24445,1934,26379
2013-Sullivan,2013,Sullivan,1547,172,1719
2013-Tioga,2013,Tioga,623,27,650
2013-Tompkins,2013,Tompkins,2793,109,2902
2013-Ulster,2013,Ulster,3286,294,3580
2013-Warren,2013,Warren,1244,53,1297
2013-Washington,2013,Washington,811,71,882
2013-Wayne,2013,Wayne,1689,153,1842
2013-Westchester,2013,Westchester,11942,2192,14134
2013-Wyoming,2013,Wyoming,469,41,510
2013-Yates,2013,Yates,399,14,413
2014-Albany,2014,Albany,8178,1003,9181
2014-Allegany,2014,Allegany,547,68,615
2014-Bronx,2014,Bronx,23317,12713,36030
2014-Broome,2014,Broome,5822,496,6318
2014-Cattaraugus,2014,Cattaraugus,1309,133,1442
2014-Cayuga,2014,Cayuga,1418,138,1556
2014-Chautauqua,2014,Chautauqua,3239,296,3535
2014-Chemung,2014,Chemung,1985,151,2136
2014-Chenango,2014,Chenango,859,50,909
2014-Clinton,2014,Clinton,1240,68,1308
2014-Columbia,2014,Columbia,879,47,926
2014-Cortland,2014,Cortland,1032,49,1081
2014-Delaware,2014,Delaware,711,58,769
2014-Dutchess,2014,Dutchess,4271,561,4832
2014-Erie,2014,Erie,24481,3932,28413
2014-Essex,2014,Essex,297,44,341
2014-Franklin,2014,Franklin,797,53,850
2014-Fulton,2014,Fulton,1402,63,1465
2014-Genesee,2014,Genesee,1406,112,1518
2014-Greene,2014,Greene,608,78,686
2014-Hamilton,2014,Hamilton,61,1,62
2014-Herkimer,2014,Herkimer,1013,110,1123
2014-Jefferson,2014,Jefferson,2357,174,2531
2014-Kings,2014,Kings,39647,17053,56700
2014-Lewis,2014,Lewis,230,27,257
2014-Livingston,2014,Livingston,849,47,896
2014-Madison,2014,Madison,1073,61,1134
2014-Monroe,2014,Monroe,19097,2227,21324
2014-Montgomery,2014,Montgomery,1203,48,1251
2014-Nassau,2014,Nassau,15637,2043,17680
2014-New York,2014,New York,39239,8327,47566
2014-Niagara,2014,Niagara,5426,798,6224
2014-Oneida,2014,Oneida,5206,560,5766
2014-Onondaga,2014,Onondaga,11464,1493,12957
2014-Ontario,2014,Ontario,2052,130,2182
2014-Orange,2014,Orange,7022,831,7853
2014-Orleans,2014,Orleans,629,58,687
2014-Oswego,2014,Oswego,2398,159,2557
2014-Otsego,2014,Otsego,786,51,837
2014-Putnam,2014,Putnam,729,51,780
2014-Queens,2014,Queens,28230,9800,38030
2014-Rensselaer,2014,Rensselaer,3788,471,4259
2014-Richmond,2014,Richmond,5314,1551,6865
2014-Rockland,2014,Rockland,3340,370,3710
2014-Saratoga,2014,Saratoga,2800,165,2965
2014-Schenectady,2014,Schenectady,4494,598,5092
2014-Schoharie,2014,Schoharie,369,11,380
2014-Schuyler,2014,Schuyler,155,10,165
2014-Seneca,2014,Seneca,664,57,721
2014-St Lawrence,2014,St Lawrence,1662,97,1759
2014-Steuben,2014,Steuben,1426,115,1541
2014-Suffolk,2014,Suffolk,24356,1765,26121
2014-Sullivan,2014,Sullivan,1489,157,1646
2014-Tioga,2014,Tioga,441,27,468
2014-Tompkins,2014,Tompkins,2501,103,2604
2014-Ulster,2014,Ulster,2969,293,3262
2014-Warren,2014,Warren,1169,40,1209
2014-Washington,2014,Washington,625,60,685
2014-Wayne,2014,Wayne,1491,112,1603
2014-Westchester,2014,Westchester,9957,2149,12106
2014-Wyoming,2014,Wyoming,344,36,380
2014-Yates,2014,Yates,303,18,321
2015-Albany,2015,Albany,7600,1041,8641
2015-Allegany,2015,Allegany,522,57,579
2015-Bronx,2015,Bronx,22890,13409,36299
2015-Broome,2015,Broome,5836,623,6459
2015-Cattaraugus,2015,Cattaraugus,1155,125,1280
2015-Cayuga,2015,Cayuga,1357,196,1553
2015-Chautauqua,2015,Chautauqua,2955,354,3309
2015-Chemung,2015,Chemung,1744,159,1903
2015-Chenango,2015,Chenango,748,101,849
2015-Clinton,2015,Clinton,1136,115,1251
2015-Columbia,2015,Columbia,792,103,895
2015-Cortland,2015,Cortland,700,51,751
2015-Delaware,2015,Delaware,661,80,741
2015-Dutchess,2015,Dutchess,3960,558,4518
2015-Erie,2015,Erie,22303,3788,26091
2015-Essex,2015,Essex,336,46,382
2015-Franklin,2015,Franklin,753,88,841
2015-Fulton,2015,Fulton,1186,123,1309
2015-Genesee,2015,Genesee,1084,115,1199
2015-Greene,2015,Greene,488,117,605
2015-Hamilton,2015,Hamilton,40,3,43
2015-Herkimer,2015,Herkimer,922,98,1020
2015-Jefferson,2015,Jefferson,2322,221,2543
2015-Kings,2015,Kings,37572,16385,53957
2015-Lewis,2015,Lewis,255,27,282
2015-Livingston,2015,Livingston,808,77,885
2015-Madison,2015,Madison,904,106,1010
2015-Monroe,2015,Monroe,18005,2526,20531
2015-Montgomery,2015,Montgomery,1165,99,1264
2015-Nassau,2015,Nassau,14374,1984,16358
2015-New York,2015,New York,38518,8789,47307
2015-Niagara,2015,Niagara,5141,779,5920
2015-Oneida,2015,Oneida,4871,585,5456
2015-Onondaga,2015,Onondaga,10074,1500,11574
2015-Ontario,2015,Ontario,1691,144,1835
2015-Orange,2015,Orange,6326,918,7244
2015-Orleans,2015,Orleans,604,69,673
2015-Oswego,2015,Oswego,2123,251,2374
2015-Otsego,2015,Otsego,763,78,841
2015-Putnam,2015,Putnam,546,43,589
2015-Queens,2015,Queens,26066,9854,35920
2015-Rensselaer,2015,Rensselaer,3653,547,4200
2015-Richmond,2015,Richmond,4814,1651,6465
2015-Rockland,2015,Rockland,3281,483,3764
2015-Saratoga,2015,Saratoga,2592,259,2851
2015-Schenectady,2015,Schenectady,3955,668,4623
2015-Schoharie,2015,Schoharie,364,38,402
2015-Schuyler,2015,Schuyler,135,14,149
2015-Seneca,2015,Seneca,668,62,730
2015-St Lawrence,2015,St Lawrence,1528,143,1671
2015-Steuben,2015,Steuben,1396,189,1585
2015-Suffolk,2015,Suffolk,22486,2010,24496
2015-Sullivan,2015,Sullivan,1160,171,1331
2015-Tioga,2015,Tioga,406,54,460
2015-Tompkins,2015,Tompkins,2149,147,2296
2015-Ulster,2015,Ulster,2707,304,3011
2015-Warren,2015,Warren,982,108,1090
2015-Washington,2015,Washington,522,91,613
2015-Wayne,2015,Wayne,1439,203,1642
2015-Westchester,2015,Westchester,10089,2146,12235
2015-Wyoming,2015,Wyoming,364,58,422
2015-Yates,2015,Yates,274,25,299
2016-Albany,2016,Albany,7668,1099,8767
2016-Allegany,2016,Allegany,490,81,571
2016-Bronx,2016,Bronx,23017,13817,36834
2016-Broome,2016,Broome,4781,641,5422
2016-Cattaraugus,2016,Cattaraugus,1094,138,1232
2016-Cayuga,2016,Cayuga,1243,184,1427
2016-Chautauqua,2016,Chautauqua,2971,356,3327
2016-Chemung,2016,Chemung,1892,172,2064
2016-Chenango,2016,Chenango,867,99,966
2016-Clinton,2016,Clinton,1260,135,1395
2016-Columbia,2016,Columbia,734,100,834
2016-Cortland,2016,Cortland,777,43,820
2016-Delaware,2016,Delaware,573,98,671
2016-Dutchess,2016,Dutchess,3550,566,4116
2016-Erie,2016,Erie,22025,3792,25817
2016-Essex,2016,Essex,338,57,395
2016-Franklin,2016,Franklin,598,108,706
2016-Fulton,2016,Fulton,1032,149,1181
2016-Genesee,2016,Genesee,1136,127,1263
2016-Greene,2016,Greene,442,104,546
2016-Hamilton,2016,Hamilton,49,5,54
2016-Herkimer,2016,Herkimer,941,121,1062
2016-Jefferson,2016,Jefferson,2098,281,2379
2016-Kings,2016,Kings,35279,15523,50802
2016-Lewis,2016,Lewis,206,30,236
2016-Livingston,2016,Livingston,795,91,886
2016-Madison,2016,Madison,905,122,1027
2016-Monroe,2016,Monroe,16281,2481,18762
2016-Montgomery,2016,Montgomery,940,83,1023
2016-Nassau,2016,Nassau,13449,1826,15275
2016-New York,2016,New York,37814,8839,46653
2016-Niagara,2016,Niagara,5294,848,6142
2016-Oneida,2016,Oneida,4572,661,5233
2016-Onondaga,2016,Onondaga,9701,1415,11116
2016-Ontario,2016,Ontario,1702,164,1866
2016-Orange,2016,Orange,6409,904,7313
2016-Orleans,2016,Orleans,671,78,749
2016-Oswego,2016,Oswego,2048,265,2313
2016-Otsego,2016,Otsego,689,90,779
2016-Putnam,2016,Putnam,566,37,603
2016-Queens,2016,Queens,24444,9356,33800
2016-Rensselaer,2016,Rensselaer,3186,472,3658
2016-Richmond,2016,Richmond,4724,1589,6313
2016-Rockland,2016,Rockland,3177,384,3561
2016-Saratoga,2016,Saratoga,2587,256,2843
2016-Schenectady,2016,Schenectady,3985,697,4682
2016-Schoharie,2016,Schoharie,349,36,385
2016-Schuyler,2016,Schuyler,105,13,118
2016-Seneca,2016,Seneca,576,67,643
2016-St Lawrence,2016,St Lawrence,1566,173,1739
2016-Steuben,2016,Steuben,1335,188,1523
2016-Suffolk,2016,Suffolk,21194,1896,23090
2016-Sullivan,2016,Sullivan,1031,198,1229
2016-Tioga,2016,Tioga,400,63,463
2016-Tompkins,2016,Tompkins,1796,158,1954
2016-Ulster,2016,Ulster,2346,295,2641
2016-Warren,2016,Warren,1089,112,1201
2016-Washington,2016,Washington,488,95,583
2016-Wayne,2016,Wayne,1459,159,1618
2016-Westchester,2016,Westchester,10424,2113,12537
2016-Wyoming,2016,Wyoming,279,48,327
2016-Yates,2016,Yates,303,17,320
2017-Albany,2017,Albany,7616,1161,8777
2017-Allegany,2017,Allegany,428,79,507
2017-Bronx,2017,Bronx,22973,12534,35507
2017-Broome,2017,Broome,4874,694,5568
2017-Cattaraugus,2017,Cattaraugus,1027,131,1158
2017-Cayuga,2017,Cayuga,1104,237,1341
2017-Chautauqua,2017,Chautauqua,2440,346,2786
2017-Chemung,2017,Chemung,1424,143,1567
2017-Chenango,2017,Chenango,604,81,685
2017-Clinton,2017,Clinton,1078,136,1214
2017-Columbia,2017,Columbia,835,135,970
2017-Cortland,2017,Cortland,945,49,994
2017-Delaware,2017,Delaware,461,59,520
2017-Dutchess,2017,Dutchess,3266,568,3834
2017-Erie,2017,Erie,19908,3463,23371
2017-Essex,2017,Essex,356,63,419
2017-Franklin,2017,Franklin,588,100,688
2017-Fulton,2017,Fulton,969,118,1087
2017-Genesee,2017,Genesee,974,168,1142
2017-Greene,2017,Greene,495,137,632
2017-Hamilton,2017,Hamilton,32,4,36
2017-Herkimer,2017,Herkimer,970,155,1125
2017-Jefferson,2017,Jefferson,2018,235,2253
2017-Kings,2017,Kings,35173,14593,49766
2017-Lewis,2017,Lewis,222,35,257
2017-Livingston,2017,Livingston,753,56,809
2017-Madison,2017,Madison,879,104,983
2017-Monroe,2017,Monroe,16375,2570,18945
2017-Montgomery,2017,Montgomery,860,78,938
2017-Nassau,2017,Nassau,12366,1650,14016
2017-New York,2017,New York,38475,8671,47146
2017-Niagara,2017,Niagara,4689,766,5455
2017-Oneida,2017,Oneida,4079,694,4773
2017-Onondaga,2017,Onondaga,9464,1429,10893
2017-Ontario,2017,Ontario,1487,135,1622
2017-Orange,2017,Orange,5865,874,6739
2017-Orleans,2017,Orleans,677,86,763
2017-Oswego,2017,Oswego,1762,218,1980
2017-Otsego,2017,Otsego,639,93,732
2017-Putnam,2017,Putnam,574,54,628
2017-Queens,2017,Queens,23676,9184,32860
2017-Rensselaer,2017,Rensselaer,3066,447,3513
2017-Richmond,2017,Richmond,4518,1451,5969
2017-Rockland,2017,Rockland,3007,397,3404
2017-Saratoga,2017,Saratoga,2516,279,2795
2017-Schenectady,2017,Schenectady,3921,671,4592
2017-Schoharie,2017,Schoharie,277,37,314
2017-Schuyler,2017,Schuyler,55,15,70
2017-Seneca,2017,Seneca,495,73,568
2017-St Lawrence,2017,St Lawrence,1378,134,1512
2017-Steuben,2017,Steuben,1092,171,1263
2017-Suffolk,2017,Suffolk,18850,1693,20543
2017-Sullivan,2017,Sullivan,1059,221,1280
2017-Tioga,2017,Tioga,408,48,456
2017-Tompkins,2017,Tompkins,1810,139,1949
2017-Ulster,2017,Ulster,2262,288,2550
2017-Warren,2017,Warren,972,107,1079
2017-Washington,2017,Washington,426,77,503
2017-Wayne,2017,Wayne,1301,186,1487
2017-Westchester,2017,Westchester,9624,1948,11572
2017-Wyoming,2017,Wyoming,275,71,346
2017-Yates,2017,Yates,233,26,259
